5 11 16
################
#@ #     ^ #   #
#  #  ######   #
#  #           #
#  ####  #######
#     #  #  #  #
####  #  #     #
#     #  #  #  #
#   ###  #  #  #
#           #  #
################
################
#              #
#   @        ^ #
#              #
#              #
#              #
#              #
#              #
#              #
#              #
################
################
#              #
#   ^          #
#              #
#              #
#              #
#              #
#              #
#         @    #
#              #
################
################
#              #
#              #
#              #
#              #
#      @ ^     #
#              #
#              #
#              #
#              #
################
################
#              #
### ######## # #
#   #      # # #
# ### #### ### #
#   # # @# #   #
### # # ## # ###
#   # #    #   #
# ### ######## #
#  %#          #
################
