1 10 14
##############
#           %#
#            #
#            #
#            #
#            #
#            #
#            #
#@           #
##############
